###                 #########
#   ###################   # #
# ####                # # # #
# ################### # # # #
#                     # # # #
##################### # # # #
#   ##                # # # #
# # ## ### ## ###### ## # # #
# #    #   ##B#         # # #
# # ############## #### # # #
### ##             #### # # #
### ############## ## # # # #
###          ##       # # # #
###### #### ### ####### # # #
###    ####             #   #
A   #########################