#B#####
# #####
#  ####
## # ##
##    #
#####A#