##    #
#  ## #
#  # B#
## # ##
#     #
#####A#