#######################
#     #           #  A#
# ### # ########### ###
#   # #       #   # # #
# ######### ### # # # #
# #       #   #   #   #
# # ##### ######### ###
#   #       #   #   # #
##### ##### # ### ### #
#   #   #     #       #
# ### ######### #######
#   #   #   #   #   # #
### # ### # ### ### # #
#   #   #   #     #   #
# ####### ##### ##### #
#       #   #   #   # #
# ##### # ### ### ### #
# #   #       #     # #
# # ######### ####### #
# #       #   #     # #
# ##### ### # ### ### #
#   #     #   #   #   #
### ####### ##### ### #
#   #       #   #     #
# ######### # ### #####
#       #   #     #   #
# ##### # ######### # #
#     #           #   #
# ### ######### # ### #
#          ###       B#
#######################